You look forward to your regularly scheduled break from this body, to go to the place where you truly belong. As eyelids come to a final close, you open your eyes and look up to a exit the larger world, guarded by a wire fence.

Dog House
This is where you can serve your purpose.

You can see a Bowl (in which is Water) here.

Red Town
An Interactive Fiction by Leo Hu
Release 1 / Serial number 250130 / Inform 7 v10.1.2 / D

Dog House
This is where you can serve your purpose.

You can see a Bowl (in which is Water) here.

>bark
You bark out loud, expressing your gratitiude for the life force that gives you the priveldge of being alive.

You feel a little better about yourself.

>bark
You bark out loud, expressing your gratitiude for the life force that gives you the priveldge of being alive.

You feel a little better about yourself.

>bark
You bark out loud, expressing your gratitiude for the life force that gives you the priveldge of being alive.

You feel a little better about yourself.
You've done good.
A bony hand reaches in through the crack between where the top of the gates meets the sky and throws you a bone.
You have been rewarded.

>bark
You bark out loud, expressing your gratitiude for the life force that gives you the priveldge of being alive.

You feel a little better about yourself.

* * *

>bark
You bark out loud, expressing your gratitiude for the life force that gives you the priveldge of being alive.

You feel a little better about yourself.
You've done good.
A bony hand reaches in through the crack between where the top of the gates meets the sky and throws you a bone.
You have been rewarded.

>eat bone
You crunch down on the hard bones and it splinters into sharp pieces. You try to swallow it, but the shards scrape your throat and you throw it all up. You've made such a mess, you have to clean it up.

>poop
You carry out your usual, distasteful deed. Blue would be so disappointed in you.

>poop
You carry out your usual, distasteful deed. Blue would be so disappointed in you.

I beg your pardon?

>poop
You carry out your usual, distasteful deed. Blue would be so disappointed in you.

* * *

>bark
You bark out loud, expressing your gratitiude for the life force that gives you the priveldge of being alive.

You feel a little better about yourself.
You've done good.
A bony hand reaches in through the crack between where the top of the gates meets the sky and throws you a bone.
You have been rewarded.

>eat bone
You crunch down on the hard bones and it splinters into sharp pieces. You try to swallow it, but the shards scrape your throat and you throw it all up. "

You've made such a mess, you have to clean it up.

>eat vomit
You scoop up a bone shard with your tongue, and crunch down on it carefully, repeatedly, until you've milled it to a powder consistency. Then you pick up another one, and repeat the same process. Blood from your scraped-up mouth mix with your stomach acid, seasoning the powder with a astringent taste you can't get enough of. "

You can feel your stomach rumbling.

>poop
You lower your butt into position and contract. A bone in the shape of a key falls out on the ground.

>poop
You carry out your usual, distasteful deed. Blue would be so disappointed in you.

>poop
You lower your butt into position and contract. A bone in the shape of a key falls out on the ground.

>take key
Taken.

>check leash
A leash is strapped around your neck and chains you to the back of the house. Its short length greatly restricts your range of motion. "

 At one end of the chain, hanging from your neck is a padlock.

>open lock
You can't see any such thing.

>open padlock
You can't see any such thing.

* * *

>poop
You carry out your usual, distasteful deed. Blue would be so disappointed in you.

>take key
Taken.

>check padlock
You see nothing special about the padlock.

>take off leash
It's locked on you.

>open padlock
It isn't something you can open.

>unlock padlock
What do you want to unlock the padlock with?

>key
You unlock the padlock.

>take off leash
You take off the leash.

>attack gate
You attack the gate.

* * *

>take key
Taken.

>open padlock with key
You unlock the padlock.

>attack wire gate
You charge at the gate, but your chain yanks you back.

>take off leash
You take off the leash.

>attack wire gate
The gate swings open from your impact. Sounds of collapse rubble come from behind you.

Red Town
The Red Town is filled with streetlights scattered around, although they barely light up the space. Not another person is in sight, so the humms of the streetlights fills the silence. That's how you like it, anyways. You turn around and see the rubble of you last shelter, lit by a three-headed streetlight above it.

* * *

>take key
Taken.

>unlock padlock
What do you want to unlock the padlock with?

* * *

>key
You unlock the padlock.

>attack gate
You can't see any such thing.

* * *

>eat bone
You crunch down on the hard bones and it splinters into sharp pieces. You try to swallow it, but the shards scrape your throat and you throw it all up. "

You've made such a mess, you have to clean it up.

>poop
You carry out your usual, distasteful deed. Blue would be so disappointed in you.

* * *

>bark
You bark out loud, expressing your gratitiude for the life force that gives you the priveldge of being alive.

You feel a little better about yourself.

>speak
You haven't earned the right to say human words.

>call for help
You haven't earned the right to say human words.

>bark
You bark out loud, expressing your gratitiude for the life force that gives you the priveldge of being alive.

You feel a little better about yourself.

* * *

>eat bone
You crunch down on the hard bones and it splinters into sharp pieces. You try to swallow it, but the shards scrape your throat and you throw it all up. You've made such a mess, you have to clean it up.

>eat vomit
You scoop up a bone shard with your tongue, and crunch down on it carefully, repeatedly, until you've milled it to a powder consistency. Then you pick up another one, and repeat the same process. Blood from the scraped-up mouth mix with your stomach acid, seasoning the powder with a hedonist taste you can't get enough of.
You can feel your stomach rumbling.

* * *

You look forward to your regularly scheduled break from this body, to go to the place where you truly belong. As eyelids come to a final close, you open your eyes and look up to a exit the larger world, guarded by a wire fence.

Dog House
This is where you can serve your purpose.

You can see a Bowl (in which is Water) here.

Red Town
An Interactive Fiction by Leo Hu
Release 1 / Serial number 250130 / Inform 7 v10.1.2 / D

Dog House
This is where you can serve your purpose.

You can see a Bowl (in which is Water) here.

>call out
You haven't earned the right to say human words.

>yell
You haven't earned the right to say human words.

>scream
You haven't earned the right to say human words.

>speak
You haven't earned the right to say human words.

>bark
You bark out loud, expressing your gratitiude for the life force that gives you the priveldge of being alive.

You feel a little better about yourself.

>bark
You bark out loud, expressing your gratitiude for the life force that gives you the priveldge of being alive.

You feel a little better about yourself.
You've done good. You should feel good about yourself.
A bony hand reaches in through the crack between where the top of the gates meets the sky and throws you a bone.
You have been rewarded.

>check dog house
You can't see any such thing.

>check bone
You see nothing special about the bone.

>eat bone
That's plainly inedible.

* * *

You look forward to your regularly scheduled break from this body, to go to the place where you truly belong. As eyelids come to a final close, you open your eyes and look up to a exit the larger world, guarded by a wire fence.

Dog House
This is where you can serve your purpose.

You can see a Bowl (in which is Water) here.

Red Town
An Interactive Fiction by Leo Hu
Release 1 / Serial number 250130 / Inform 7 v10.1.2 / D

Dog House
This is where you can serve your purpose.

You can see a Bowl (in which is Water) here.

>check leash
A leash is strapped around your neck and chains you to the back of the house. Its short length greatly restricts your range of motion. "

 At one end of the chain is a padlock.

>take off leash
You take off the leash.

* * *

You look forward to your regularly scheduled break from this body, to go to the place where you truly belong. As eyelids come to a final close, you open your eyes and look up to a exit the larger world, guarded by a wire fence.

Dog House
This is where you can serve your purpose.

You can see a Bowl (in which is Water) here.

Red Town
An Interactive Fiction by Leo Hu
Release 1 / Serial number 250130 / Inform 7 v10.1.2 / D

Dog House
This is where you can serve your purpose.

You can see a Bowl (in which is Water) here.

>check pockets
You can't see any such thing.

* * *

You look forward to your regularly scheduled break from this body, to go to the place where you truly belong. As eyelids come to a final close, you open your eyes and look up to a exit the larger world, guarded by a wire fence.

Dog House
This is where you can serve your purpose.

You can see a Bowl (in which is Water) here.

Red Town
An Interactive Fiction by Leo Hu
Release 1 / Serial number 250130 / Inform 7 v10.1.2 / D

Dog House
This is where you can serve your purpose.

You can see a Bowl (in which is Water) here.

>check streelight
You can't see any such thing.

>check the streetlight
(the four headed streetlight)
The neck splits into four, each with a head that is slightly lower. Only the tallest light is turned on. You're tall enough to reach the lowest light.

>check lowest light
You can't see any such thing.

>open streetlight
(the four headed streetlight)
It isn't something you can open.

>take light bulb
You can't see any such thing.

>check lowest light
You can't see any such thing.

>check in the streetlight
I only understood you as far as wanting to check inside.

>check inside the four headed streetlight
I only understood you as far as wanting to check inside.

* * *

You look forward to your regularly scheduled break from this body, to go to the place where you truly belong. As eyelids come to a final close, you open your eyes and look up to a exit the larger world, guarded by a wire fence.

Dog House
This is where you can serve your purpose.

You can see a Bowl (in which is Water) here.

Red Town
An Interactive Fiction by Leo Hu
Release 1 / Serial number 250130 / Inform 7 v10.1.2 / D

Dog House
This is where you can serve your purpose.

You can see a Bowl (in which is Water) here.

>open dog house
You open the dog house, revealing a bone key.

>check dog house
It's an empty dog house with a grid door. I wonder where the dog went. There's something shiny in there that seems to be reflecting the red light.

>pick up key
You can't see any such thing.

>pick up bone key
You can't see any such thing.

* * *

>open dog house
You open the dog house, revealing a bone key.

>take bone key
Taken.

>open lotus door with bone key
You unlock the Lotus door.

>enter lotus door
(first opening the Lotus door)

Lotus Waters
You see an overlay of bubbles floating around you. You might be under water, but your breathing is just fine. A shallow stream of water with a pink tint flows down your ankles calmly, and lotuses in full bloom slowly drift on the surface. In the center of this slow stream stands a stone wall with runic writing on it.

You can see a Lotus door here.

>enter lotus door
Red Town
The Red Town is filled with streetlights scattered around, although they barely light up the space. There is a dog house in the bottom right corner.

You can see a Lotus door and a dog house (empty) here.

>check streetlight
Another street light. The red light makes you look guilty.

* * *

>open dog house
You open the dog house, revealing a bone key.

>take bone key'
I only understood you as far as wanting to take the bone key.

>take bone key
Taken.

>open lotus door
It seems to be locked.

>use bone key on lotus door
That's not a verb I recognise.

>open lotus door with bone key
That doesn't seem to fit the lock.

* * *

You look forward to your regularly scheduled break from this body, to go to the place where you truly belong. As eyelids come to a final close, you open your eyes and look up to a exit the larger world, guarded by a wire fence.

Dog House
This is where you can serve your purpose.

You can see a Bowl (in which is Water) here.

Red Town
An Interactive Fiction by Leo Hu
Release 1 / Serial number 250130 / Inform 7 v10.1.2 / D

Dog House
This is where you can serve your purpose.

You can see a Bowl (in which is Water) here.

>open lotus door
It seems to be locked.

>check dog house
It's an empty dog house with a grid door. I wonder where the dog went. There's something shiny in there that seems to be reflecting the red light.

>open dog house
It isn't something you can open.

* * *

You look forward to your regularly scheduled break from this body, to go to the place where you truly belong. As eyelids come to a final close, you open your eyes and look up to a exit the larger world, guarded by a wire fence.

Dog House
This is where you can serve your purpose.

You can see a Bowl (in which is Water) here.

Red Town
An Interactive Fiction by Leo Hu
Release 1 / Serial number 250130 / Inform 7 v10.1.2 / D

Dog House
This is where you can serve your purpose.

You can see a Bowl (in which is Water) here.

>open the dog house
You open the dog house.

>check the dog house
It's an empty dog house with a grid door. I wonder where the dog went. There's something shiny in there that seems to be reflecting the red light.

>check inside dog house
I only understood you as far as wanting to check inside.

>check the dog house
It's an empty dog house with a grid door. I wonder where the dog went. There's something shiny in there that seems to be reflecting the red light.

>grab the key
That's not a verb I recognise.

>pick up key
You can't see any such thing.

* * *

You look forward to your regularly scheduled break from this body, to go to the place where you truly belong. As eyelids come to a final close, you open your eyes and look up to a exit the larger world, guarded by a wire fence.

Dog House
This is where you can serve your purpose.

You can see a Bowl (in which is Water) here.

Red Town
An Interactive Fiction by Leo Hu
Release 1 / Serial number 250130 / Inform 7 v10.1.2 / D

Dog House
This is where you can serve your purpose.

You can see a Bowl (in which is Water) here.

>open the window
It cannot be opened.

* * *

You look forward to your regularly scheduled break from this body, to go to the place where you truly belong. As eyelids come to a final close, you open your eyes and look up to a exit the larger world, guarded by a wire fence.

Dog House
This is where you can serve your purpose.

You can see a Bowl (in which is Water) here.

Red Town
An Interactive Fiction by Leo Hu
Release 1 / Serial number 250130 / Inform 7 v10.1.2 / D

Dog House
This is where you can serve your purpose.

You can see a Bowl (in which is Water) here.

>poop
You carry out your usual, distasteful deed. Blue would be so disappointed in you.

>attack
(the leash)
Violence isn't the answer to this one.

>attack gate
You can't see any such thing.

>attack fence
You charge at the gate, but your chain yanks you back.

>bark
You bark out loud, expressing your gratitiude for the life force that gives you the priveldge of being alive.

You feel a little better about yourself.

* * *

>bark
You bark out loud, expressing your gratitiude for the life force that gives you the priveldge of being alive.

You feel a little better about yourself.
You've done good.
A bony hand reaches in through the crack between where the top of the gates meets the sky and throws you a bone.
You have been rewarded.

>eat bone
You crunch down on the hard bones and it splinters into sharp pieces. You try to swallow it, but the shards scrape your throat and you throw it all up. "

You've sullied your last resort, and there's nowhere lower you could go.

    *** Your rotten soul is beyond saving. ***

Would you like to RESTART, RESTORE a saved game, QUIT or UNDO the last command?

>restart
You look forward to your regularly scheduled break from this body, to go to the place where you truly belong. As eyelids come to a final close, you open your eyes and look up to a exit the larger world, guarded by a wire fence.

Dog House
This is where you can serve your purpose.

You can see a wire fence and a Bowl (in which is Water) here.

Red Town
An Interactive Fiction by Leo Hu
Release 1 / Serial number 250130 / Inform 7 v10.1.2 / D

Dog House
This is where you can serve your purpose.

You can see a wire fence and a Bowl (in which is Water) here.

>bark
You bark out loud, expressing your gratitiude for the life force that gives you the priveldge of being alive.

You feel a little better about yourself.

* * *

>poop
You carry out your usual, distasteful deed. Blue would be so disappointed in you.

>bark
You bark out loud, expressing your gratitiude for the life force that gives you the priveldge of being alive.

You feel a little better about yourself.

>barak
That's not a verb I recognise.

>bark
You bark out loud, expressing your gratitiude for the life force that gives you the priveldge of being alive.

You feel a little better about yourself.

* * *

>bark
You bark out loud, expressing your gratitiude for the life force that gives you the priveldge of being alive.

You feel a little better about yourself.
You've done good.
A bony hand reaches in through the crack between where the top of the gates meets the sky and throws you a bone.
You have been rewarded.

>eat bone
You crunch down on the hard bones and it splinters into sharp pieces. You try to swallow it, but the shards scrape your throat and you throw it all up. You've sullied your last resort, and there's nowhere lower you could go.

    *** Your rotten soul is beyond saving. ***

Would you like to RESTART, RESTORE a saved game, QUIT or UNDO the last command?

* * *

>eat bone
You crunch down on the hard bones and it splinters into sharp pieces. You try to swallow it, but the shards scrape your throat and you throw it all up. "

You've sullied your last resort, and there's nowhere lower you could go.

    *** Your rotten soul is beyond saving. ***

Would you like to RESTART, RESTORE a saved game, QUIT or UNDO the last command?

>restart
You look forward to your regularly scheduled break from this body, to go to the place where you truly belong. As eyelids come to a final close, you open your eyes and look up to a exit the larger world, guarded by a wire fence.

Dog House
This is where you can serve your purpose.

You can see a Bowl (in which is Water) here.

Red Town
An Interactive Fiction by Leo Hu
Release 1 / Serial number 250128 / Inform 7 v10.1.2 / D

Dog House
This is where you can serve your purpose.

You can see a Bowl (in which is Water) here.

>bark
You bark out loud, expressing your gratitiude for the life force that gives you the priveldge of being alive.

You feel a little better about yourself.

* * *

>poop
You carry out your usual, distasteful deed. Blue would be so disappointed in you.

>poop
You carry out your usual, distasteful deed. Blue would be so disappointed in you.
You've sullied your last resort, and there's nowhere lower you could go.

    *** Your rotten soul is beyond saving. ***

Would you like to RESTART, RESTORE a saved game, QUIT or UNDO the last command?

* * *

>bark
You bark out loud, expressing your gratitiude for the life force that gives you the priveldge of being alive.

You feel a little better about yourself.
You've done good.
A bony hand reaches in through the crack between where the top of the gates meets the sky and throws you a bone.
You have been rewarded.

>eat bone
You crunch down on the hard bones and it splinters into sharp pieces. You try to swallow it, but the shards scrape your throat and you throw it all up. end in despair

* * *

>poop
You carry out your usual, distasteful deed. Blue would be so disappointed in you.

>popp
That's not a verb I recognise.

>bark
You bark out loud, expressing your gratitiude for the life force that gives you the priveldge of being alive.

You feel a little better about yourself.

* * *

You look forward to your regularly scheduled break from this body, to go to the place where you truly belong. As eyelids come to a final close, you open your eyes and look up to a exit the larger world, guarded by a wire fence.

Dog House
This is where you can serve your purpose.

You can see a Bowl (in which is Water) here.

Red Town
An Interactive Fiction by Leo Hu
Release 1 / Serial number 250130 / Inform 7 v10.1.2 / D

Dog House
This is where you can serve your purpose.

You can see a Bowl (in which is Water) here.

>speak
You haven't earned the right to say human words.

* * *

>bark
You bark out loud, expressing your gratitiude for the life force that gives you the priveldge of being alive.

You feel a little better about yourself.

>barking
That's not a verb I recognise.

>bark at the gate
That's not a verb I recognise.