You awaken in darkness, your body encased in a sleek cryosuit. Cold padding presses against your back, and your breath fogs up the interior of the glass pod. Blinking lights from a small control panel inside catch your eye. Your muscles ache, but you can move.

Darkness
It is pitch dark, and you can't see a thing.

Philosophical Robot
An Interactive Fiction by Anastasia Salter
Release 1 / Serial number 250123 / Inform 7 v10.1.2 / D

Darkness
It is pitch dark, and you can't see a thing.

>check control panel
It is pitch dark, and you can't see a thing.

* * *

You awaken in darkness, your body encased in a sleek cryosuit. Cold padding presses against your back, and your breath fogs up the interior of the glass pod. Blinking lights from a small control panel inside catch your eye. Your muscles ache, but you can move.

Darkness
It is pitch dark, and you can't see a thing.

Philosophical Robot
An Interactive Fiction by Anastasia Salter
Release 1 / Serial number 250123 / Inform 7 v10.1.2 / D

Darkness
It is pitch dark, and you can't see a thing.

>press the blue putton
You can't see any such thing.

>push blue button
You press the blue button. Instantly, the interior of the cryopod hums to life. The padded interior molds itself around you, and cold mist begins to seep into the chamber.
Your limbs grow heavy as a strange lethargy takes hold. Before long, the world fades into icy darkness, and you slip into a dreamless slumber.

    *** You have returned to cryogenic sleep, perhaps for eternity. ***

Would you like to RESTART, RESTORE a saved game, QUIT or UNDO the last command?

* * *

You awaken in darkness, your body encased in a sleek cryosuit. Cold padding presses against your back, and your breath fogs up the interior of the glass pod. Blinking lights from a small control panel inside catch your eye. Your muscles ache, but you can move.

Darkness
It is pitch dark, and you can't see a thing.

Philosophical Robot
An Interactive Fiction by Anastasia Salter
Release 1 / Serial number 250123 / Inform 7 v10.1.2 / D

Darkness
It is pitch dark, and you can't see a thing.

>push button
You press the button, and with a hiss of air, the glass door of the cryopod unlocks and swings open. Cold mist spills out, dissipating into the chamber as you take your first shaky steps outside.

Hallway
The guide is a tall figure clad in a smooth, featureless suit that shimmers faintly under the dim lights. Their face is obscured, but their voice carries a calm authority.

A strange object glints faintly on the floor. Its surface seems to shift and ripple slightly as if alive. It exudes a faint sense of dread.

The endtable is starkly metal, like eveything else. There's a small drawer in it.

You can also see a portal here.

>ask guide where humanity went
"Where?" the guide muses. "Gone to the void, scattered across the winds of time. Their home is dust, their legacy etched in memory."

>insult the guide
You hesitate to attack the room with the Robot's steely gaze upon you.

* * *

>check guide
You see nothing special about the guide.

>talk to guide
That's not a verb I recognise.

>ask guide where i am
The Guide goes haha and says nothing."

>ask guide where humanity is
The Guide goes haha and says nothing."

>ask guide what happened to humanity
The Guide goes haha and says nothing."

* * *

>open drawer
You pull open the small drawer, revealing a keycard inside. It looks important.

>check endtable
You see nothing special about the endtable.

* * *

>open drawer
You pull open the small drawer, revealing a keycard inside. It looks important.

>take keycard
Taken.

>open portal
The portal won't budge.

>unlock portal
(with the keycard)
That doesn't seem to fit the lock.

>insert keycard into portal
You open the gate.

>enter portal
(first opening the portal)

library
This library used to hold countless books. Now the shelves are empty and dusty, as all media has been consumed by the machine.

A humanoid figure constructed of polished metal and shimmering circuits stands in the center of the room. His eyes glow faintly, betraying a mind engaged in constant computation.

You can also see a portal here.

>greet robot
The robot's face lights up with a digital smile. "Hello, human! I am excited to meet the last of your kind. You must have many questions."

>ask robot why rain
Robot pauses, his circuits whirring faintly. "Your question exceeds my programming. A failure-but perhaps an opportunity for growth."

* * *

>pick up ominous object
The moment your fingers touch the object, an intense shock surges through your body. Pain sears through your nerves as a deep, otherworldly voice whispers in your mind: "Unworthy." Your vision fades to black as the cold metallic floor rushes up to meet you.

    *** You have died. ***

Would you like to RESTART, RESTORE a saved game, QUIT or UNDO the last command?

* * *

You awaken in darkness, your body encased in a sleek cryosuit. Cold padding presses against your back, and your breath fogs up the interior of the glass pod. Blinking lights from a small control panel inside catch your eye. Your muscles ache, but you can move.

Darkness
It is pitch dark, and you can't see a thing.

Philosophical Robot
An Interactive Fiction by Anastasia Salter
Release 1 / Serial number 250123 / Inform 7 v10.1.2 / D

Darkness
It is pitch dark, and you can't see a thing.

>push the button
You press the button, and with a hiss of air, the glass door of the cryopod unlocks and swings open. Cold mist spills out, dissipating into the chamber as you take your first shaky steps outside.

Cryofreeze Chamber
The chamber is dimly lit, bathed in an eerie bluish glow from the frosted glass walls. A low hum of machinery fills the air, punctuated by the occasional hiss of escaping steam. The cryopod you are in is closed tightly, its interior lined with synthetic padding that fits the contours of your body.

The cryopod encloses you in a frosted glass capsule, its interior lined with cold padding. A small control panel is embedded on the inside, with a blinking green button labeled "Unlock".

>push the button
You press the button, and with a hiss of air, the glass door of the cryopod unlocks and swings open. Cold mist spills out, dissipating into the chamber as you take your first shaky steps outside.

Cryofreeze Chamber
The chamber is dimly lit, bathed in an eerie bluish glow from the frosted glass walls. A low hum of machinery fills the air, punctuated by the occasional hiss of escaping steam. The cryopod you are in is closed tightly, its interior lined with synthetic padding that fits the contours of your body.

The cryopod encloses you in a frosted glass capsule, its interior lined with cold padding. A small control panel is embedded on the inside, with a blinking green button labeled "Unlock".